##########
#...@.g..#
#ll......#
#..####..#
#........#
#........#
#.....#..#
#........#
#.......+#
##########
