##########
#...@....#
##.......#
#..####..#
#........#
#.-......#
#.....#..#
#.g......#
#........#
##########
